{
	"levels":
		[{"tileMap":
				["######",
				 "#    #",
				 "#X   #",
				 "#    #",
				 "#  BP#",
				 "######"]
		},
		 {"tileMap":
			  ["######",
				 "#    #",
				 "#B   #",
				 "#    #",
				 "#   P#",
				 "######"]
		 },
		 {"tileMap":
			  ["######",
				 "#    #",
				 "#    #",
				 "# X  #",
				 "#  BP#",
				 "######"]
		 },
		 {"tileMap":
			  ["######",
				 "#  B #",
				 "#    #",
				 "#    #",
				 "#   P#",
				 "######"]
		 },
		 {"tileMap":
			  ["######",
				 "# X  #",
				 "#    #",
				 "#    #",
				 "# B P#",
				 "######"]
		 }
		]
}
