{
	"levels":
		[{"tileMap":
				["######",
				 "#    #",
				 "#X   #",
				 "#  B #",
				 "#   P#",
				 "######"]
		},
		 {"tileMap":
			  ["######",
				 "#P X #",
				 "#    #",
				 "#    #",
				 "# B  #",
				 "######"]
		 },
		 {"tileMap":
	 		  ["######",
				 "#    #",
				 "#    #",
				 "# XB #",
				 "#   P#",
				 "######"]
		 },
		 {"tileMap":
			  ["######",
				 "#    #",
				 "#X B #",
				 "#    #",
				 "#   P#",
				 "######"]
		 },
		 {"tileMap":
			  ["######",
				 "# X  #",
				 "#    #",
				 "# B  #",
				 "#   P#",
				 "######"]
		 }
		]
}
