{
  "levels": [
    {
      "tileMap": [
        "##########",
        "#        #",
        "# X      #",
        "# B      #",
        "#   P    #",
        "#        #",
        "# X B    #",
        "#        #",
        "#X B     #",
        "##########"
      ],
      "marks": [
        [2, 2],
        [6, 2],
        [8, 1]
      ]
    },
    {
      "tileMap": [
        "##########",
        "#        #",
        "#   B    #",
        "#   X    #",
        "#   P  B #",
        "#   B X  #",
        "#        #",
        "#      X #",
        "#        #",
        "##########"
      ],
      "marks": [
        [3, 4],
        [5, 6],
        [7, 7]
      ]
    },
    {
      "tileMap": [
        "##########",
        "#        #",
        "#        #",
        "#        #",
        "#   P    #",
        "#X       #",
        "#B       #",
        "#  B  B  #",
        "#  X   X #",
        "##########"
      ],
      "marks": [
        [5, 1],
        [8, 3],
        [8, 7]
      ]
    },
    {
      "tileMap": [
        "##########",
        "#        #",
        "#X       #",
        "#      B #",
        "#X  P B  #",
        "#        #",
        "#        #",
        "#        #",
        "#   BX   #",
        "##########"
      ],
      "marks": [
        [2, 1],
        [4, 1],
        [8, 5]
      ]
    },
    {
      "tileMap": [
        "##########",
        "#        #",
        "#   B    #",
        "#   X    #",
        "#   P    #",
        "#        #",
        "#        #",
        "# B      #",
        "# X  X B #",
        "##########"
      ],
      "marks": [
        [3, 4],
        [8, 2],
        [8, 5]
      ]
    }
  ]
}