{
  "levels": [
    {
      "tileMap": [
        "########",
        "#      #",
        "#   B  #",
        "# B X  #",
        "# X P  #",
        "#      #",
        "#      #",
        "########"
      ],
      "marks": [
        [3, 4],
        [4, 2]
      ]
    },
    {
      "tileMap": [
        "########",
        "#  X   #",
        "#  B   #",
        "# X    #",
        "# B P  #",
        "#      #",
        "#      #",
        "########"
      ],
      "marks": [
        [1, 3],
        [3, 2]
      ]
    },
    {
      "tileMap": [
        "########",
        "#      #",
        "#  B   #",
        "#      #",
        "#X  P  #",
        "#      #",
        "# X B  #",
        "########"
      ],
      "marks": [
        [4, 1],
        [6, 2]
      ]
    },
    {
      "tileMap": [
        "########",
        "#   X  #",
        "# B    #",
        "# B    #",
        "#  P   #",
        "#      #",
        "#  X   #",
        "########"
      ],
      "marks": [
        [1, 4],
        [6, 3]
      ]
    },
    {
      "tileMap": [
        "########",
        "#      #",
        "#  B   #",
        "#  X   #",
        "#  P   #",
        "#      #",
        "# X B  #",
        "########"
      ],
      "marks": [
        [3, 3],
        [6, 2]
      ]
    }
  ]
}